1111111111111
10000000000C1
100000EC00001
1P00000000001
1111111111111