11111111111111111
1C0111110E1110C01
11001111101111101
110000P0100000001
11C11110011111101
10000000000000001
11111111111111111